<Camera>
#(x,y,vX,vY,width,height,limitX,limitY)
0,0,0,0,236,188,2816,470
</Camera>

<MapInfo>
#(tileSize, spaceBetweenTiles, tilesPerRowInTileSet, tilesPerColumnInTileSet, width, height)
16,1,16,8,2816,470
</MapInfo>

<MapIndexes>
37 37 37 37 37 37 37 37 37 37 37 37 37 37 37 37 37 37 37 37 37 37 37 37 37 37 37 37 37 37 37 37 37 37 37 37 37 37 37 37 37 37 37 37 37 37 37 37 37 37 37 37 37 37 37 37 37 37 37 37 37 37 37 37 37 37 37 37 37 37 37 37 37 37 37 37 37 37 37 37 37 37 37 37 37 37 37 37 37 37 37 37 37 37 37 37 37 37 37 37 37 37 37 37 37 37 37 37 37 37 37 37 37 37 37 37 37 37 37 37 37 37 37 37 37 37 37 37 37 37 37 37 37 37 37 37 37 37 37 37 37 37 37 37 37 37 37 37 37 34 37 37 37 34 37 42 28 28 28 28 28 28 28 28 28 28 28 28 28 28 28 28 28 28 28 28
37 37 37 37 37 37 37 37 37 37 37 37 37 37 37 37 37 37 37 37 37 37 37 37 37 37 37 37 37 37 37 37 37 37 37 37 37 37 37 37 37 37 35 37 37 37 37 34 37 37 37 37 37 37 37 37 37 37 37 37 37 37 37 37 37 37 37 37 37 37 37 37 37 37 37 37 37 37 37 37 37 37 37 37 37 37 37 37 37 37 37 37 37 37 37 37 37 37 37 37 37 37 37 37 37 37 37 37 37 37 37 37 37 37 37 37 37 37 37 37 36 37 35 37 37 37 37 37 37 37 37 37 37 37 37 37 37 37 37 37 37 37 37 37 37 37 37 37 37 37 37 37 37 37 37 42 28 28 28 28 28 28 28 28 28 28 28 28 28 28 28 28 28 28 28 28
37 37 37 37 37 37 37 34 37 37 37 37 37 37 37 37 36 37 37 37 37 34 37 37 37 37 37 37 37 37 37 37 37 37 37 37 37 37 37 37 37 37 37 37 37 37 37 37 37 37 37 37 37 37 37 37 37 37 37 37 37 37 37 37 37 37 37 37 37 37 37 37 37 37 37 37 37 37 37 37 37 37 37 37 37 34 37 37 37 37 37 37 37 37 37 37 37 37 37 37 37 34 37 37 37 37 37 37 37 37 37 37 37 37 37 37 37 37 37 37 37 37 37 37 37 37 37 37 37 37 37 37 37 37 37 37 37 37 37 37 37 37 37 37 37 37 37 37 37 37 37 37 37 37 37 42 28 28 28 28 28 28 28 28 28 28 28 28 28 28 28 28 28 28 28 28
37 37 37 37 37 37 37 37 37 37 37 37 37 37 37 37 37 37 37 37 37 37 37 37 37 37 37 37 37 37 37 37 37 37 37 37 37 34 35 37 37 37 37 37 37 37 37 34 37 37 35 37 37 37 37 37 37 37 37 37 37 37 37 37 37 37 37 37 37 37 37 37 37 37 37 37 37 37 37 34 37 37 37 37 37 37 37 37 37 37 37 37 37 37 37 37 37 37 37 37 37 37 37 37 37 37 37 37 37 37 37 37 37 37 37 37 37 37 37 37 37 37 37 37 37 37 37 37 37 37 37 37 37 37 37 37 37 37 37 37 37 37 37 37 37 37 37 37 37 37 37 37 37 37 37 42 28 28 28 28 28 28 28 28 28 28 28 28 28 28 28 28 28 28 28 28
37 37 37 37 37 37 37 37 37 37 37 37 37 37 35 37 36 37 37 37 37 37 37 34 37 37 37 37 37 37 37 37 37 37 37 37 37 37 37 37 37 37 37 37 37 37 37 37 37 37 37 37 36 37 37 37 37 37 37 37 37 37 37 37 37 37 37 37 37 37 37 37 37 37 37 37 37 37 37 37 37 37 37 37 37 37 37 37 37 37 37 37 37 37 35 37 37 37 37 37 37 37 37 37 37 34 37 37 36 37 37 37 37 37 37 37 37 37 37 37 37 37 37 37 37 37 37 37 37 37 37 37 37 37 37 37 37 37 37 37 37 37 37 37 37 37 37 37 37 37 37 37 37 37 37 42 28 28 28 28 28 28 28 28 28 28 28 28 28 28 28 28 28 28 28 28
37 37 37 37 37 37 37 37 37 37 37 37 37 37 37 37 37 37 35 34 37 37 37 37 37 37 37 37 37 37 37 37 37 37 37 37 37 37 37 37 37 37 37 37 37 37 37 37 37 37 37 37 37 37 37 37 37 37 37 37 37 37 37 37 37 37 37 37 37 37 37 37 37 37 37 37 37 37 37 37 37 37 37 37 37 37 37 37 37 37 37 37 37 34 37 37 37 37 37 37 37 37 37 37 37 37 37 37 37 37 37 37 37 37 37 37 36 37 37 37 37 37 37 37 37 37 37 37 37 37 37 37 37 37 37 37 37 37 37 34 37 37 37 37 37 37 37 37 37 37 37 37 37 37 37 42 28 28 28 28 28 28 28 28 28 28 28 28 28 28 28 28 28 28 28 28
37 37 37 37 37 37 37 37 37 37 37 37 37 37 37 37 37 37 37 37 37 37 37 37 37 37 37 37 37 37 37 37 37 37 37 37 37 37 37 37 37 37 37 37 37 37 37 37 37 37 37 37 37 37 37 37 37 37 37 37 36 37 37 37 37 37 37 37 37 37 37 37 37 37 37 37 37 37 37 37 37 37 37 37 37 37 37 37 37 37 37 34 37 37 35 37 37 37 37 37 37 37 37 37 37 37 37 37 37 37 37 37 37 37 37 37 37 37 37 37 37 37 37 37 37 37 37 37 37 37 37 37 37 37 37 37 37 37 37 37 37 37 37 37 37 37 37 37 37 37 37 37 37 37 37 42 28 28 28 28 28 28 28 28 28 28 28 28 28 28 28 28 28 28 28 28
37 37 37 37 37 37 37 37 37 37 37 37 37 37 37 37 37 37 37 37 37 37 37 37 37 37 37 37 37 37 37 37 37 37 37 37 37 37 37 37 37 37 37 37 37 37 37 37 37 37 37 37 37 37 37 37 37 37 37 37 37 37 37 37 37 37 37 37 37 37 37 37 37 37 37 37 37 37 37 37 37 37 37 37 37 37 37 37 37 37 37 37 37 37 37 37 37 37 37 37 37 37 37 37 37 37 37 37 37 37 37 37 37 37 37 37 37 37 37 37 37 37 37 37 37 37 37 37 37 37 37 37 36 37 37 37 37 37 37 37 37 0 1 37 37 37 37 37 37 37 37 37 37 37 37 42 28 28 28 28 28 28 28 28 28 28 28 28 28 28 28 28 28 28 28 28
37 37 37 37 37 37 37 37 37 37 37 37 37 37 37 37 37 37 37 37 37 37 37 37 37 37 37 37 37 37 37 37 37 37 37 37 37 37 37 37 37 37 37 37 37 37 37 37 37 37 37 37 37 37 37 37 37 37 37 37 37 37 37 37 37 37 37 37 37 34 37 37 37 37 37 37 37 37 37 37 37 37 37 37 37 37 37 37 37 37 37 37 37 37 37 37 37 37 37 37 37 37 37 37 37 37 37 37 37 37 37 37 37 37 37 37 37 37 37 37 37 37 37 37 37 37 37 37 37 37 37 37 37 37 37 37 37 37 37 37 37 16 17 37 37 37 37 37 37 37 37 34 37 37 37 42 28 28 28 28 28 28 28 28 28 28 28 28 28 28 28 28 28 28 28 28
37 37 37 37 37 37 37 37 37 37 37 37 37 37 37 37 37 37 37 37 37 37 37 37 37 37 37 37 37 37 37 37 37 37 37 37 37 37 37 37 37 37 37 37 37 37 37 37 37 37 37 37 37 37 37 37 37 37 37 37 37 37 37 37 37 37 37 37 37 37 37 37 37 37 35 37 36 37 37 37 37 37 76 77 77 78 37 34 37 37 37 37 37 37 37 37 37 37 37 37 37 37 37 37 37 37 37 37 37 37 37 37 37 37 37 37 37 37 37 37 36 37 37 37 37 37 37 37 37 37 37 37 37 37 37 37 37 37 37 37 37 16 17 37 37 37 37 37 37 37 37 37 37 37 37 42 28 28 28 28 28 28 28 28 28 28 28 28 28 28 28 28 28 28 28 28
37 37 37 37 37 37 37 37 37 37 37 37 37 37 37 37 37 37 37 37 37 37 37 37 37 37 37 37 37 37 37 37 37 37 37 37 37 37 37 37 37 37 37 37 37 37 37 37 37 37 37 37 37 37 37 37 37 37 37 37 37 37 37 37 37 37 37 37 37 37 37 37 37 37 37 37 37 37 37 37 37 37 108 109 109 110 37 37 37 37 37 37 37 37 37 37 37 37 37 37 37 37 37 37 37 37 37 37 37 37 37 37 37 37 37 37 37 37 37 37 37 37 37 37 37 37 37 37 37 37 37 37 37 37 37 37 37 37 37 37 37 16 17 37 37 37 37 37 37 37 37 37 37 37 37 42 28 28 28 28 28 28 28 28 28 28 28 28 28 28 28 28 28 28 28 28
37 37 37 37 37 37 37 37 37 37 37 37 37 37 37 37 37 37 37 37 37 37 37 37 37 37 37 37 37 37 37 37 37 37 37 37 37 37 37 37 37 37 37 37 37 37 37 37 37 37 37 37 37 37 37 37 37 37 37 37 37 37 37 37 37 37 37 37 37 37 37 37 37 37 37 37 37 37 37 37 37 37 37 37 37 37 37 37 37 37 37 37 37 50 50 50 50 50 50 50 50 50 50 50 50 50 37 37 37 37 37 37 37 37 37 37 37 37 37 37 37 37 37 37 37 37 37 37 37 37 37 37 37 37 37 37 37 37 37 37 37 16 17 37 37 37 37 37 37 37 37 37 37 37 37 42 28 28 28 28 28 28 28 28 28 28 28 28 28 28 28 28 28 28 28 28
37 37 37 37 37 37 37 37 37 37 37 37 37 37 37 37 37 37 37 37 37 37 37 37 37 37 37 37 37 37 37 37 37 37 37 37 37 37 37 37 37 37 37 37 37 37 37 37 37 37 37 37 37 37 37 37 37 37 37 37 37 37 37 37 37 37 37 37 37 37 37 37 37 37 37 37 37 37 37 37 37 37 37 37 37 37 37 37 50 50 50 50 37 37 37 37 37 37 37 37 37 37 37 37 37 37 37 37 37 37 37 37 37 37 37 37 37 37 37 37 37 37 37 37 37 37 37 37 37 37 37 37 37 37 37 37 37 37 37 37 37 16 17 37 37 37 37 37 37 37 37 37 37 37 37 42 28 28 28 28 28 28 28 28 28 28 28 28 28 28 28 28 28 28 28 28
37 37 37 37 37 37 37 37 37 37 37 37 37 37 37 37 37 37 37 37 37 37 37 37 37 37 37 37 37 37 37 37 37 37 37 37 37 37 37 37 37 37 37 37 37 37 37 37 37 37 37 37 37 37 37 37 37 37 37 37 37 37 37 37 37 37 37 37 37 37 37 37 37 37 37 37 37 37 37 37 37 37 37 37 37 37 37 37 37 37 37 37 37 37 37 37 37 37 37 37 37 37 37 37 37 37 37 37 37 37 37 37 37 37 37 37 37 37 37 37 37 37 37 37 37 37 37 37 37 37 37 37 37 37 37 37 37 37 37 37 37 16 17 37 37 37 37 37 37 37 37 37 37 37 37 42 28 28 28 28 28 28 28 28 28 28 28 28 28 28 28 28 28 28 28 28
37 37 37 37 37 37 37 37 37 37 37 37 37 37 37 37 37 37 37 37 37 37 37 37 37 37 37 37 37 37 37 37 37 37 37 37 37 37 37 37 37 37 37 37 37 37 37 37 37 37 37 37 37 37 37 37 37 37 37 37 37 37 37 37 37 37 37 37 37 37 37 37 37 37 37 37 37 37 37 37 37 37 37 37 37 37 37 37 37 37 37 37 37 37 37 37 37 37 37 37 37 37 37 37 37 37 37 37 37 37 37 37 37 37 37 37 37 37 37 37 37 37 37 37 37 37 37 37 37 37 37 37 37 37 37 37 37 37 37 37 37 16 17 37 37 37 37 37 37 37 37 37 37 37 37 42 28 28 28 28 28 28 28 28 28 28 28 28 28 28 28 28 28 28 28 28
37 37 37 37 37 37 37 37 37 37 37 37 37 37 37 37 37 37 37 37 37 37 37 37 37 37 37 37 37 37 37 37 37 37 37 37 37 37 37 37 37 37 37 37 37 37 37 37 37 37 37 37 37 37 37 37 37 37 37 37 37 37 37 37 37 37 37 37 37 37 37 37 37 37 37 37 37 37 37 37 37 37 37 37 37 37 37 37 37 37 37 37 37 37 37 37 37 37 37 37 37 37 37 37 37 37 37 37 37 37 37 37 37 37 37 37 37 37 37 37 37 37 37 37 37 37 37 37 37 37 37 37 37 37 37 37 37 37 37 37 37 16 17 37 37 37 37 37 37 37 37 37 37 37 37 42 28 28 28 28 28 28 28 28 28 28 28 28 28 28 28 28 28 28 28 28
37 37 37 37 37 37 37 37 37 37 37 37 37 37 37 37 37 37 37 37 37 37 37 37 37 37 37 37 37 37 37 37 37 37 37 37 37 37 37 37 37 37 37 37 37 37 37 37 37 37 37 37 37 37 37 37 37 37 37 37 37 37 37 37 37 37 37 37 37 37 37 37 37 37 37 37 37 37 37 37 37 37 37 37 37 37 37 37 37 37 37 37 37 37 37 37 37 37 37 37 37 37 37 37 37 37 37 37 37 37 37 37 37 37 37 37 37 37 37 37 37 37 37 37 37 37 37 37 37 37 37 37 37 37 37 37 37 37 37 37 37 16 17 37 37 37 37 37 37 37 37 37 37 37 37 42 28 28 28 28 28 28 28 28 28 28 28 28 28 28 28 28 28 28 28 28
37 37 37 37 37 37 37 37 51 52 53 37 37 37 37 37 37 37 37 37 37 37 37 37 37 37 37 37 37 37 37 37 37 37 37 37 37 37 37 37 51 52 53 37 37 37 37 37 37 37 37 37 37 37 37 37 37 37 37 37 37 37 37 37 37 37 37 37 37 37 37 37 37 37 37 37 37 37 37 37 37 37 37 37 37 37 37 37 37 37 37 37 37 37 37 37 37 37 37 37 37 37 37 51 52 52 52 53 37 37 37 37 37 37 37 37 37 37 37 37 37 37 37 37 37 37 37 37 37 37 37 37 37 37 37 37 80 81 82 85 37 16 17 37 37 37 37 37 37 37 37 37 37 37 37 42 28 28 28 28 28 28 28 28 28 28 28 28 28 28 28 28 28 28 28 28
37 37 37 37 37 37 37 37 67 68 69 37 37 37 37 37 37 37 37 37 37 37 37 37 37 37 37 37 37 37 37 37 37 37 37 37 37 37 37 37 67 68 69 37 37 37 37 37 37 37 37 37 37 37 37 37 37 37 37 37 37 37 37 37 37 37 37 37 37 37 37 37 37 37 37 37 37 37 37 37 37 37 37 37 37 37 37 37 37 37 37 37 37 37 37 37 37 37 37 37 37 37 37 67 68 68 68 69 37 37 37 37 37 37 37 37 37 37 37 37 37 37 37 37 37 37 37 37 37 37 37 37 37 37 37 37 96 56 98 101 37 16 17 37 37 51 52 53 37 37 72 73 37 37 37 42 28 28 28 28 28 28 28 28 28 28 28 28 28 28 28 28 28 28 28 28
37 37 37 37 37 37 37 37 37 37 37 37 37 37 37 37 37 37 37 37 37 37 37 37 37 37 37 37 37 37 37 37 102 103 103 104 85 37 37 37 37 37 37 37 51 52 52 52 53 37 37 37 37 37 37 37 37 37 37 37 37 37 37 37 37 37 37 37 37 37 37 37 37 37 37 37 37 37 37 37 37 37 37 37 37 37 37 37 37 37 37 37 37 37 37 37 37 37 37 37 37 37 37 37 37 37 37 37 37 37 37 37 37 37 37 37 37 37 37 37 37 37 37 37 37 37 37 37 37 37 37 37 37 37 37 37 96 56 98 101 37 29 29 37 37 67 68 69 37 37 70 86 73 37 37 42 28 28 28 28 28 28 28 28 28 28 28 28 28 28 28 28 28 28 28 28
37 37 37 37 37 37 37 37 37 37 37 37 37 37 37 37 37 37 37 37 37 37 37 37 37 37 37 37 37 37 37 37 118 119 119 120 101 37 37 37 37 37 37 37 67 68 68 68 69 37 37 37 37 37 37 37 37 37 37 37 37 37 37 37 37 37 37 37 37 37 37 37 37 37 37 37 37 37 37 37 37 37 37 89 90 90 90 90 90 91 37 37 37 37 37 37 37 37 37 37 37 37 37 37 37 37 37 37 37 37 37 37 37 37 37 37 37 37 37 37 37 37 37 37 37 37 37 37 37 37 37 37 37 37 37 37 96 56 98 101 37 37 37 37 37 37 37 37 37 37 70 88 71 37 37 42 28 28 28 28 28 28 44 45 28 28 28 28 28 28 28 28 28 28 28 28
37 37 37 37 37 37 37 37 37 37 37 37 37 37 37 37 37 89 90 91 37 37 37 37 37 37 37 37 37 76 77 77 78 84 119 120 101 37 37 37 37 37 37 37 37 37 37 37 37 37 37 37 37 37 37 72 73 37 37 37 37 37 37 37 37 37 37 37 37 37 37 37 37 37 37 37 37 37 37 37 37 37 37 105 106 106 106 106 106 107 37 37 37 37 29 29 37 37 37 37 37 37 37 37 37 37 37 37 37 37 37 37 37 37 37 37 37 37 37 37 37 37 37 37 37 37 37 37 37 37 37 37 37 37 37 37 96 56 98 101 37 37 37 37 37 37 37 37 37 72 87 88 71 37 37 42 28 28 28 28 28 28 60 61 28 28 28 28 28 28 28 28 28 28 28 28
37 37 72 73 37 37 37 37 37 37 37 37 37 37 37 37 37 105 106 107 37 37 37 37 37 37 37 37 37 92 93 93 94 100 119 120 101 37 37 37 37 37 37 37 37 37 37 37 37 37 37 37 72 73 72 87 71 72 73 37 72 73 37 37 37 37 37 37 37 37 37 37 37 37 37 37 37 37 37 37 37 76 77 77 77 77 77 78 79 107 37 37 37 37 37 37 37 37 37 37 37 37 37 37 37 37 37 37 37 37 37 37 37 37 37 37 37 37 37 37 37 37 37 37 37 37 37 37 37 37 37 37 37 37 37 37 96 56 98 101 37 37 37 37 37 37 37 37 72 87 88 88 71 37 37 42 28 28 28 28 28 28 60 44 45 28 28 28 28 28 28 28 28 28 28 28
37 72 87 71 72 73 72 73 37 37 37 37 37 37 37 76 77 78 79 107 37 37 37 37 37 80 81 81 81 82 83 93 94 100 119 120 101 37 37 37 37 37 37 37 37 37 37 37 37 37 37 37 70 86 87 86 87 88 71 37 70 86 73 37 37 37 37 37 37 37 37 37 37 37 37 37 37 37 37 37 37 92 93 93 93 93 93 94 95 107 37 37 37 37 37 37 37 37 37 37 29 37 37 37 29 37 37 37 37 37 37 37 37 37 37 37 37 37 37 72 73 37 37 37 37 37 37 37 37 37 37 37 37 37 76 77 78 33 98 101 37 29 29 37 37 37 37 37 70 88 88 88 71 37 37 42 28 28 28 28 28 28 60 28 61 28 28 28 28 28 28 28 28 44 45 28
37 70 86 87 88 71 70 86 73 37 37 37 37 37 37 92 93 94 95 107 37 37 37 37 37 96 56 56 56 98 99 93 80 81 81 81 81 82 37 37 37 37 66 66 66 66 66 66 37 37 37 72 87 88 88 88 88 88 71 72 87 88 71 37 37 37 37 37 37 37 37 37 37 37 37 37 37 37 37 80 81 81 81 81 81 82 83 94 95 107 37 37 37 37 37 37 37 37 37 29 29 37 37 37 29 29 37 37 37 37 37 37 37 37 37 37 37 37 37 70 86 73 37 37 37 37 37 37 37 37 37 37 37 37 92 93 94 49 98 101 37 16 17 37 37 37 37 37 70 88 88 88 86 73 37 42 28 28 28 28 28 28 60 28 44 45 28 28 28 28 28 28 28 60 61 28
37 70 88 88 88 86 87 88 71 37 66 66 66 37 37 108 109 110 111 123 37 37 37 37 37 112 113 113 113 114 115 109 112 113 113 113 113 114 37 4 5 5 5 5 5 5 5 5 5 5 5 5 5 5 5 5 5 5 5 5 5 5 5 5 5 5 5 6 37 37 37 37 37 37 37 37 37 37 37 112 113 113 113 113 113 114 115 110 111 123 37 37 37 37 37 37 37 37 29 29 29 37 37 37 29 29 29 37 37 37 37 37 37 37 37 37 37 37 72 87 88 71 37 37 37 37 37 37 37 37 37 37 37 37 108 109 110 65 114 101 37 16 17 37 37 37 37 37 70 88 88 88 88 71 37 42 28 28 28 28 28 44 45 28 28 61 28 28 28 28 28 28 44 45 61 28
4 5 5 5 5 5 5 5 5 5 5 5 5 5 5 5 5 5 5 5 5 5 5 5 5 5 5 5 5 5 5 5 5 5 5 5 5 5 6 20 21 21 21 21 21 21 21 21 21 21 21 21 21 21 21 21 21 21 21 21 21 21 21 21 21 21 21 22 37 37 37 37 4 5 5 5 5 5 5 5 5 5 5 5 5 5 5 5 5 5 5 5 5 6 37 37 4 5 5 5 6 37 37 37 4 5 5 5 5 5 5 5 5 5 5 5 5 5 5 5 5 5 5 5 5 5 5 5 5 5 5 5 5 5 5 5 5 5 5 6 37 4 5 5 5 5 5 5 5 5 5 5 5 5 5 5 5 5 5 5 5 5 5 5 5 5 5 5 5 5 5 5 5 5 5 6
</MapIndexes>

<MarioInfo>
#(x,y,limitX,limitY,state)
100,0,2816,470,DROPPING
</MarioInfo>

<Grounds>
#(x,y,width,height,id,cellX,cellY)
0,416,624,48,0
624,400,464,64,1
1152,416,352,48,2
1536,416,80,48,3
1664,416,572,48,4
# decreased 4 for upper line(576 -> 572)
2260,416,560,48,5
# increased 4 for upper line(2256 -> 2260)

# Ground stairs
1504,336,32,16,6

1568,400,16,16,7
1584,384,16,32,8
1600,368,16,48,9

1664,400,48,16,10
1664,384,32,16,11
1664,368,16,16,12

#Ground GreenPipes
2256,368,32,48,13
2256,112,32,208,14
</Grounds>

<BlockFrames>
240,368,48,48,15
272,336,48,80,16
400,368,80,48,17
464,336,64,80,18
512,304,64,112,19
512,384,96,32,20
1262,384,112,32,21
1296,352,112,64,22
1328,320,112,96,23
1312,144,64,32,24
2144,368,48,48,25
2176,272,48,144,26
</BlockFrames>

# Golden Brick: Static Animation(for UI) + Ground(for collision)
<GoldenBrickFrames>
# (x, y, width, height, id)
1952,400,16,16,27
1968,400,16,16,28
1984,400,16,16,29
2000,400,16,16,30
2016,400,16,16,31
2032,400,16,16,32
2048,400,16,16,33

1968,384,16,16,34
1984,384,16,16,35
2000,384,16,16,36
2016,384,16,16,37
2032,384,16,16,38

1984,368,16,16,39
2000,368,16,16,40
2016,368,16,16,41
2032,368,16,16,42

2096,400,16,16,43
2112,400,16,16,44
2096,384,16,16,45
</GoldenBrickFrames>

<GiftBrickFrames>
# (x, y, width, height, id, giftCode, giftWidth, giftHeight, griftVx, giftVy, giftId)
# giftCode:
# 0: mush room. Only giftbrick has mush => has 11 numbers
# 1: 100 points
176,352,16,16,46,1
192,352,16,16,47,1

224,304,16,16,48,1
240,304,16,16,49,0,16,16,1,1,54
</GiftBrickFrames>

<GreenPipeFrames>
# (x, y, width, height, floorQuantity, id)
# floorQuantity: 3 or 2
352,368,32,48,3,50
1792,384,32,32,2,51
1856,368,32,48,3,52
2320,384,32,32,2,53
</GreenPipeFrames>

<GoombaFrames>
300,400,16,16,-1,0,55
</GoombaFrames>

<GridInfo>
# (totalRow, totalCol, cellHeight, cellWidth)
5,22,94,128
</GridInfo>

<GridMatrixId>
# every pair
# > id
# cellX1,cellY1_cellX2,cellY2
> 0
0,4_1,4_2,4_3,4_4,4

> 1
4,4_5,4_6,4_7,4_8,4

> 2
8,4_9,4_10,4_11,4

> 3
11,4_12,4

> 4
12,4_13,4_14,4_15,4_16,4_17,4

> 5
17,4_18,4_19,4_20,4_21,4

> 6
11,3

> 7
12,4

> 8
12,3_12,4

> 9
12,3_12,4

> 10
12,4_13,4

> 11
12,3_13,3_12,4_13,4

> 12
12,3_13,3_12,4_13,4

> 13
17,3_17,4

> 14
17,1_17,2_17,3

> 15
1,3_1,4_2,3_2,4

> 16
2,3_2,4

> 17
3,3_3,4

> 18
3,3_3,4_4,3_4,4

> 19
4,3_4,4

> 20
4,4

> 21
9,4_10,4

> 22
10,3_10,4_11,3_11,4

> 23
10,3_10,4_11,3_11,4

> 24
10,1

> 25
16,3_16,4_17,3_17,4

> 26
17,2_17,3_17,4

> 27
15,4

> 28
15,4

> 29
15,4

> 30
15,4

> 31
15,4

> 32
15,4

> 33
15,4

> 34
15,3

> 35
15,3

> 36
15,3

> 37
15,3

> 38
15,3

> 39
15,3

> 40
15,3

> 41
15,3

> 42
15,3

> 43
16,4

> 44
16,4

> 45
16,3

> 46
1,3

> 47
1,3

> 48
1,3

> 49
1,3

> 50
2,3_2,4_3,3_3,4

> 51
14,4

> 52
14,3_14,4

> 53
18,4

> 54
1,3

> 55
0,4
</GridMatrixId>

<AnimationBundle>
# > id, startIndexFrame, animationDelay
# if has 4 numbers in line => just get frame
# if has 8 numbers in line => get bounds then get frame 
# Mario Stading
2,0,12,15,0,0,16,16
> 0 0 2

# Mario Running
2,0,12,15,0,0,16,16
16,0,15,16,16,0,16,16
> 1 0 2

# Mario: Jumping & Dropping
32,0,16,16
> 2 0 2

# Mario: Die & Die Jumping & Die Dropping
48,0,16,16
> 3 0 20

# GoldenBrickAnimation
# (x, y, width, height)
204,119,16,16
221,119,16,16
238,119,16,16
255,119,16,16
> 4 0 4

# GiftBrick secret animation
170,0,16,16
187,0,16,16
204,0,16,16
221,0,16,16
> 5 0 4

# GiftBrick empty box
238,0,16,16
> 6 0 10

# GiftBrick coin animation
255,0,16,16
255,17,16,16
255,34,16,16
255,51,16,16
> 7 0 4

# GiftBrick 100 coins
102,34,16,16
> 8 0 10

# Goomba Moving
0,136,16,16
17,136,16,16
> 9 0 3

# Trampled Goomba
34,136,16,16
> 10 0 3

# Green Pipe 3 floors
0,153,32,48
> 11 0 10

# Green Pipe 2 floors
33,153,32,32
> 12 0 10

# Super Mushroom
238,17,16,16
> 13 0 4

</AnimationBundle>