<Camera>
#(x,y,vX,vY,width,height,limitX,limitY)
0,0,0,0,236,188,2816,470
</Camera>

<MapInfo>
#(tileSize, spaceBetweenTiles, tilesPerRowInTileSet, tilesPerColumnInTileSet, width, height)
16,1,16,8,2816,470
</MapInfo>

<MapIndexes>
37 37 37 37 37 37 37 37 37 37 37 37 37 37 37 37 37 37 37 37 37 37 37 37 37 37 37 37 37 37 37 37 37 37 37 37 37 37 37 37 37 37 37 37 37 37 37 37 37 37 37 37 37 37 37 37 37 37 37 37 37 37 37 37 37 37 37 37 37 37 37 37 37 37 37 37 37 37 37 37 37 37 37 37 37 37 37 37 37 37 37 37 37 37 37 37 37 37 37 37 37 37 37 37 37 37 37 37 37 37 37 37 37 37 37 37 37 37 37 37 37 37 37 37 37 37 37 37 37 37 37 37 37 37 37 37 37 37 37 37 37 37 37 37 37 37 37 37 37 34 37 37 37 34 37 42 28 28 28 28 28 28 28 28 28 28 28 28 28 28 28 28 28 28 28 28
37 37 37 37 37 37 37 37 37 37 37 37 37 37 37 37 37 37 37 37 37 37 37 37 37 37 37 37 37 37 37 37 37 37 37 37 37 37 37 37 37 37 35 37 37 37 37 34 37 37 37 37 37 37 37 37 37 37 37 37 37 37 37 37 37 37 37 37 37 37 37 37 37 37 37 37 37 37 37 37 37 37 37 37 37 37 37 37 37 37 37 37 37 37 37 37 37 37 37 37 37 37 37 37 37 37 37 37 37 37 37 37 37 37 37 37 37 37 37 37 36 37 35 37 37 37 37 37 37 37 37 37 37 37 37 37 37 37 37 37 37 37 37 37 37 37 37 37 37 37 37 37 37 37 37 42 28 28 28 28 28 28 28 28 28 28 28 28 28 28 28 28 28 28 28 28
37 37 37 37 37 37 37 34 37 37 37 37 37 37 37 37 36 37 37 37 37 34 37 37 37 37 37 37 37 37 37 37 37 37 37 37 37 37 37 37 37 37 37 37 37 37 37 37 37 37 37 37 37 37 37 37 37 37 37 37 37 37 37 37 37 37 37 37 37 37 37 37 37 37 37 37 37 37 37 37 37 37 37 37 37 34 37 37 37 37 37 37 37 37 37 37 37 37 37 37 37 34 37 37 37 37 37 37 37 37 37 37 37 37 37 37 37 37 37 37 37 37 37 37 37 37 37 37 37 37 37 37 37 37 37 37 37 37 37 37 37 37 37 37 37 37 37 37 37 37 37 37 37 37 37 42 28 28 28 28 28 28 28 28 28 28 28 28 28 28 28 28 28 28 28 28
37 37 37 37 37 37 37 37 37 37 37 37 37 37 37 37 37 37 37 37 37 37 37 37 37 37 37 37 37 37 37 37 37 37 37 37 37 34 35 37 37 37 37 37 37 37 37 34 37 37 35 37 37 37 37 37 37 37 37 37 37 37 37 37 37 37 37 37 37 37 37 37 37 37 37 37 37 37 37 34 37 37 37 37 37 37 37 37 37 37 37 37 37 37 37 37 37 37 37 37 37 37 37 37 37 37 37 37 37 37 37 37 37 37 37 37 37 37 37 37 37 37 37 37 37 37 37 37 37 37 37 37 37 37 37 37 37 37 37 37 37 37 37 37 37 37 37 37 37 37 37 37 37 37 37 42 28 28 28 28 28 28 28 28 28 28 28 28 28 28 28 28 28 28 28 28
37 37 37 37 37 37 37 37 37 37 37 37 37 37 35 37 36 37 37 37 37 37 37 34 37 37 37 37 37 37 37 37 37 37 37 37 37 37 37 37 37 37 37 37 37 37 37 37 37 37 37 37 36 37 37 37 37 37 37 37 37 37 37 37 37 37 37 37 37 37 37 37 37 37 37 37 37 37 37 37 37 37 37 37 37 37 37 37 37 37 37 37 37 37 35 37 37 37 37 37 37 37 37 37 37 34 37 37 36 37 37 37 37 37 37 37 37 37 37 37 37 37 37 37 37 37 37 37 37 37 37 37 37 37 37 37 37 37 37 37 37 37 37 37 37 37 37 37 37 37 37 37 37 37 37 42 28 28 28 28 28 28 28 28 28 28 28 28 28 28 28 28 28 28 28 28
37 37 37 37 37 37 37 37 37 37 37 37 37 37 37 37 37 37 35 34 37 37 37 37 37 37 37 37 37 37 37 37 37 37 37 37 37 37 37 37 37 37 37 37 37 37 37 37 37 37 37 37 37 37 37 37 37 37 37 37 37 37 37 37 37 37 37 37 37 37 37 37 37 37 37 37 37 37 37 37 37 37 37 37 37 37 37 37 37 37 37 37 37 34 37 37 37 37 37 37 37 37 37 37 37 37 37 37 37 37 37 37 37 37 37 37 36 37 37 37 37 37 37 37 37 37 37 37 37 37 37 37 37 37 37 37 37 37 37 34 37 37 37 37 37 37 37 37 37 37 37 37 37 37 37 42 28 28 28 28 28 28 28 28 28 28 28 28 28 28 28 28 28 28 28 28
37 37 37 37 37 37 37 37 37 37 37 37 37 37 37 37 37 37 37 37 37 37 37 37 37 37 37 37 37 37 37 37 37 37 37 37 37 37 37 37 37 37 37 37 37 37 37 37 37 37 37 37 37 37 37 37 37 37 37 37 36 37 37 37 37 37 37 37 37 37 37 37 37 37 37 37 37 37 37 37 37 37 37 37 37 37 37 37 37 37 37 34 37 37 35 37 37 37 37 37 37 37 37 37 37 37 37 37 37 37 37 37 37 37 37 37 37 37 37 37 37 37 37 37 37 37 37 37 37 37 37 37 37 37 37 37 37 37 37 37 37 37 37 37 37 37 37 37 37 37 37 37 37 37 37 42 28 28 28 28 28 28 28 28 28 28 28 28 28 28 28 28 28 28 28 28
37 37 37 37 37 37 37 37 37 37 37 37 37 37 37 37 37 37 37 37 37 37 37 37 37 37 37 37 37 37 37 37 37 37 37 37 37 37 37 37 37 37 37 37 37 37 37 37 37 37 37 37 37 37 37 37 37 37 37 37 37 37 37 37 37 37 37 37 37 37 37 37 37 37 37 37 37 37 37 37 37 37 37 37 37 37 37 37 37 37 37 37 37 37 37 37 37 37 37 37 37 37 37 37 37 37 37 37 37 37 37 37 37 37 37 37 37 37 37 37 37 37 37 37 37 37 37 37 37 37 37 37 36 37 37 37 37 37 37 37 37 0 1 37 37 37 37 37 37 37 37 37 37 37 37 42 28 28 28 28 28 28 28 28 28 28 28 28 28 28 28 28 28 28 28 28
37 37 37 37 37 37 37 37 37 37 37 37 37 37 37 37 37 37 37 37 37 37 37 37 37 37 37 37 37 37 37 37 37 37 37 37 37 37 37 37 37 37 37 37 37 37 37 37 37 37 37 37 37 37 37 37 37 37 37 37 37 37 37 37 37 37 37 37 37 34 37 37 37 37 37 37 37 37 37 37 37 37 37 37 37 37 37 37 37 37 37 37 37 37 37 37 37 37 37 37 37 37 37 37 37 37 37 37 37 37 37 37 37 37 37 37 37 37 37 37 37 37 37 37 37 37 37 37 37 37 37 37 37 37 37 37 37 37 37 37 37 16 17 37 37 37 37 37 37 37 37 34 37 37 37 42 28 28 28 28 28 28 28 28 28 28 28 28 28 28 28 28 28 28 28 28
37 37 37 37 37 37 37 37 37 37 37 37 37 37 37 37 37 37 37 37 37 37 37 37 37 37 37 37 37 37 37 37 37 37 37 37 37 37 37 37 37 37 37 37 37 37 37 37 37 37 37 37 37 37 37 37 37 37 37 37 37 37 37 37 37 37 37 37 37 37 37 37 37 37 35 37 36 37 37 37 37 37 76 77 77 78 37 34 37 37 37 37 37 37 37 37 37 37 37 37 37 37 37 37 37 37 37 37 37 37 37 37 37 37 37 37 37 37 37 37 36 37 37 37 37 37 37 37 37 37 37 37 37 37 37 37 37 37 37 37 37 16 17 37 37 37 37 37 37 37 37 37 37 37 37 42 28 28 28 28 28 28 28 28 28 28 28 28 28 28 28 28 28 28 28 28
37 37 37 37 37 37 37 37 37 37 37 37 37 37 37 37 37 37 37 37 37 37 37 37 37 37 37 37 37 37 37 37 37 37 37 37 37 37 37 37 37 37 37 37 37 37 37 37 37 37 37 37 37 37 37 37 37 37 37 37 37 37 37 37 37 37 37 37 37 37 37 37 37 37 37 37 37 37 37 37 37 37 108 109 109 110 37 37 37 37 37 37 37 37 37 37 37 37 37 37 37 37 37 37 37 37 37 37 37 37 37 37 37 37 37 37 37 37 37 37 37 37 37 37 37 37 37 37 37 37 37 37 37 37 37 37 37 37 37 37 37 16 17 37 37 37 37 37 37 37 37 37 37 37 37 42 28 28 28 28 28 28 28 28 28 28 28 28 28 28 28 28 28 28 28 28
37 37 37 37 37 37 37 37 37 37 37 37 37 37 37 37 37 37 37 37 37 37 37 37 37 37 37 37 37 37 37 37 37 37 37 37 37 37 37 37 37 37 37 37 37 37 37 37 37 37 37 37 37 37 37 37 37 37 37 37 37 37 37 37 37 37 37 37 37 37 37 37 37 37 37 37 37 37 37 37 37 37 37 37 37 37 37 37 37 37 37 37 37 50 50 50 50 50 50 50 50 50 50 50 50 50 37 37 37 37 37 37 37 37 37 37 37 37 37 37 37 37 37 37 37 37 37 37 37 37 37 37 37 37 37 37 37 37 37 37 37 16 17 37 37 37 37 37 37 37 37 37 37 37 37 42 28 28 28 28 28 28 28 28 28 28 28 28 28 28 28 28 28 28 28 28
37 37 37 37 37 37 37 37 37 37 37 37 37 37 37 37 37 37 37 37 37 37 37 37 37 37 37 37 37 37 37 37 37 37 37 37 37 37 37 37 37 37 37 37 37 37 37 37 37 37 37 37 37 37 37 37 37 37 37 37 37 37 37 37 37 37 37 37 37 37 37 37 37 37 37 37 37 37 37 37 37 37 37 37 37 37 37 37 50 50 50 50 37 37 37 37 37 37 37 37 37 37 37 37 37 37 37 37 37 37 37 37 37 37 37 37 37 37 37 37 37 37 37 37 37 37 37 37 37 37 37 37 37 37 37 37 37 37 37 37 37 16 17 37 37 37 37 37 37 37 37 37 37 37 37 42 28 28 28 28 28 28 28 28 28 28 28 28 28 28 28 28 28 28 28 28
37 37 37 37 37 37 37 37 37 37 37 37 37 37 37 37 37 37 37 37 37 37 37 37 37 37 37 37 37 37 37 37 37 37 37 37 37 37 37 37 37 37 37 37 37 37 37 37 37 37 37 37 37 37 37 37 37 37 37 37 37 37 37 37 37 37 37 37 37 37 37 37 37 37 37 37 37 37 37 37 37 37 37 37 37 37 37 37 37 37 37 37 37 37 37 37 37 37 37 37 37 37 37 37 37 37 37 37 37 37 37 37 37 37 37 37 37 37 37 37 37 37 37 37 37 37 37 37 37 37 37 37 37 37 37 37 37 37 37 37 37 16 17 37 37 37 37 37 37 37 37 37 37 37 37 42 28 28 28 28 28 28 28 28 28 28 28 28 28 28 28 28 28 28 28 28
37 37 37 37 37 37 37 37 37 37 37 37 37 37 37 37 37 37 37 37 37 37 37 37 37 37 37 37 37 37 37 37 37 37 37 37 37 37 37 37 37 37 37 37 37 37 37 37 37 37 37 37 37 37 37 37 37 37 37 37 37 37 37 37 37 37 37 37 37 37 37 37 37 37 37 37 37 37 37 37 37 37 37 37 37 37 37 37 37 37 37 37 37 37 37 37 37 37 37 37 37 37 37 37 37 37 37 37 37 37 37 37 37 37 37 37 37 37 37 37 37 37 37 37 37 37 37 37 37 37 37 37 37 37 37 37 37 37 37 37 37 16 17 37 37 37 37 37 37 37 37 37 37 37 37 42 28 28 28 28 28 28 28 28 28 28 28 28 28 28 28 28 28 28 28 28
37 37 37 37 37 37 37 37 37 37 37 37 37 37 37 37 37 37 37 37 37 37 37 37 37 37 37 37 37 37 37 37 37 37 37 37 37 37 37 37 37 37 37 37 37 37 37 37 37 37 37 37 37 37 37 37 37 37 37 37 37 37 37 37 37 37 37 37 37 37 37 37 37 37 37 37 37 37 37 37 37 37 37 37 37 37 37 37 37 37 37 37 37 37 37 37 37 37 37 37 37 37 37 37 37 37 37 37 37 37 37 37 37 37 37 37 37 37 37 37 37 37 37 37 37 37 37 37 37 37 37 37 37 37 37 37 37 37 37 37 37 16 17 37 37 37 37 37 37 37 37 37 37 37 37 42 28 28 28 28 28 28 28 28 28 28 28 28 28 28 28 28 28 28 28 28
37 37 37 37 37 37 37 37 37 37 37 37 37 37 37 37 37 37 37 37 37 37 37 37 37 37 37 37 37 37 37 37 37 37 37 37 37 37 37 37 37 37 37 37 37 37 37 37 37 37 37 37 37 37 37 37 37 37 37 37 37 37 37 37 37 37 37 37 37 37 37 37 37 37 37 37 37 37 37 37 37 37 37 37 37 37 37 37 37 37 37 37 37 37 37 37 37 37 37 37 37 37 37 37 37 37 37 37 37 37 37 37 37 37 37 37 37 37 37 37 37 37 37 37 37 37 37 37 37 37 37 37 37 37 37 37 37 37 37 37 37 16 17 37 37 37 37 37 37 37 37 37 37 37 37 42 28 28 28 28 28 28 28 28 28 28 28 28 28 28 28 28 28 28 28 28
37 37 37 37 37 37 37 37 51 52 53 37 37 37 37 37 37 37 37 37 37 37 37 37 37 37 37 37 37 37 37 37 37 37 37 37 37 37 37 37 51 52 53 37 37 37 37 37 37 37 37 37 37 37 37 37 37 37 37 37 37 37 37 37 37 37 37 37 37 37 37 37 37 37 37 37 37 37 37 37 37 37 37 37 37 37 37 37 37 37 37 37 37 37 37 37 37 37 37 37 37 37 37 51 52 52 52 53 37 37 37 37 37 37 37 37 37 37 37 37 37 37 37 37 37 37 37 37 37 37 37 37 37 37 37 37 80 81 82 85 37 16 17 37 37 37 37 37 37 37 37 37 37 37 37 42 28 28 28 28 28 28 28 28 28 28 28 28 28 28 28 28 28 28 28 28
37 37 37 37 37 37 37 37 67 68 69 37 37 37 37 37 37 37 37 37 37 37 37 37 37 37 37 37 37 37 37 37 37 37 37 37 37 37 37 37 67 68 69 37 37 37 37 37 37 37 37 37 37 37 37 37 37 37 37 37 37 37 37 37 37 37 37 37 37 37 37 37 37 37 37 37 37 37 37 37 37 37 37 37 37 37 37 37 37 37 37 37 37 37 37 37 37 37 37 37 37 37 37 67 68 68 68 69 37 37 37 37 37 37 37 37 37 37 37 37 37 37 37 37 37 37 37 37 37 37 37 37 37 37 37 37 96 56 98 101 37 16 17 37 37 51 52 53 37 37 72 73 37 37 37 42 28 28 28 28 28 28 28 28 28 28 28 28 28 28 28 28 28 28 28 28
37 37 37 37 37 37 37 37 37 37 37 37 37 37 37 37 37 37 37 37 37 37 37 37 37 37 37 37 37 37 37 37 102 103 103 104 85 37 37 37 37 37 37 37 51 52 52 52 53 37 37 37 37 37 37 37 37 37 37 37 37 37 37 37 37 37 37 37 37 37 37 37 37 37 37 37 37 37 37 37 37 37 37 37 37 37 37 37 37 37 37 37 37 37 37 37 37 37 37 37 37 37 37 37 37 37 37 37 37 37 37 37 37 37 37 37 37 37 37 37 37 37 37 37 37 37 37 37 37 37 37 37 37 37 37 37 96 56 98 101 37 29 29 37 37 67 68 69 37 37 70 86 73 37 37 42 28 28 28 28 28 28 28 28 28 28 28 28 28 28 28 28 28 28 28 28
37 37 37 37 37 37 37 37 37 37 37 37 37 37 37 37 37 37 37 37 37 37 37 37 37 37 37 37 37 37 37 37 118 119 119 120 101 37 37 37 37 37 37 37 67 68 68 68 69 37 37 37 37 37 37 37 37 37 37 37 37 37 37 37 37 37 37 37 37 37 37 37 37 37 37 37 37 37 37 37 37 37 37 89 90 90 90 90 90 91 37 37 37 37 37 37 37 37 37 37 37 37 37 37 37 37 37 37 37 37 37 37 37 37 37 37 37 37 37 37 37 37 37 37 37 37 37 37 37 37 37 37 37 37 37 37 96 56 98 101 37 37 37 37 37 37 37 37 37 37 70 88 71 37 37 42 28 28 28 28 28 28 44 45 28 28 28 28 28 28 28 28 28 28 28 28
37 37 37 37 37 37 37 37 37 37 37 37 37 37 37 37 37 89 90 91 37 37 37 37 37 37 37 37 37 76 77 77 78 84 119 120 101 37 37 37 37 37 37 37 37 37 37 37 37 37 37 37 37 37 37 72 73 37 37 37 37 37 37 37 37 37 37 37 37 37 37 37 37 37 37 37 37 37 37 37 37 37 37 105 106 106 106 106 106 107 37 37 37 37 29 29 37 37 37 37 37 37 37 37 37 37 37 37 37 37 37 37 37 37 37 37 37 37 37 37 37 37 37 37 37 37 37 37 37 37 37 37 37 37 37 37 96 56 98 101 37 37 37 37 37 37 37 37 37 72 87 88 71 37 37 42 28 28 28 28 28 28 60 61 28 28 28 28 28 28 28 28 28 28 28 28
37 37 72 73 37 37 37 37 37 37 37 37 37 37 37 37 37 105 106 107 37 37 37 37 37 37 37 37 37 92 93 93 94 100 119 120 101 37 37 37 37 37 37 37 37 37 37 37 37 37 37 37 72 73 72 87 71 72 73 37 72 73 37 37 37 37 37 37 37 37 37 37 37 37 37 37 37 37 37 37 37 76 77 77 77 77 77 78 79 107 37 37 37 37 37 37 37 37 37 37 37 37 37 37 37 37 37 37 37 37 37 37 37 37 37 37 37 37 37 37 37 37 37 37 37 37 37 37 37 37 37 37 37 37 37 37 96 56 98 101 37 37 37 37 37 37 37 37 72 87 88 88 71 37 37 42 28 28 28 28 28 28 60 44 45 28 28 28 28 28 28 28 28 28 28 28
37 72 87 71 72 73 72 73 37 37 37 37 37 37 37 76 77 78 79 107 37 37 0 1 37 80 81 81 81 82 83 93 94 100 119 120 101 37 37 37 37 37 37 37 37 37 37 37 37 37 37 37 70 86 87 86 87 88 71 37 70 86 73 37 37 37 37 37 37 37 37 37 37 37 37 37 37 37 37 37 37 92 93 93 93 93 93 94 95 107 37 37 37 37 37 37 37 37 37 37 29 37 37 37 29 37 37 37 37 37 37 37 37 37 37 37 0 1 37 72 73 37 37 37 37 37 37 37 37 37 37 37 37 37 76 77 78 33 98 101 37 29 29 37 37 37 37 37 70 88 88 88 71 37 37 42 28 28 28 28 28 28 60 28 61 28 28 28 28 28 28 28 28 44 45 28
37 70 86 87 88 71 70 86 73 37 37 37 37 37 37 92 93 94 95 107 37 37 16 17 37 96 56 56 56 98 99 93 80 81 81 81 81 82 37 37 37 37 66 66 66 66 66 66 37 37 37 72 87 88 88 88 88 88 71 72 87 88 71 37 37 37 37 37 37 37 37 37 37 37 37 37 37 37 37 80 81 81 81 81 81 82 83 94 95 107 37 37 37 37 37 37 37 37 37 29 29 37 37 37 29 29 37 37 37 37 37 37 0 1 37 37 16 17 37 70 86 73 37 37 37 37 37 37 37 37 37 37 37 37 92 93 94 49 98 101 37 16 17 37 37 0 1 37 70 88 88 88 86 73 37 42 28 28 28 28 28 28 60 28 44 45 28 28 28 28 28 28 28 60 61 28
37 70 88 88 88 86 87 88 71 37 66 66 66 37 37 108 109 110 111 123 37 37 16 17 37 112 113 113 113 114 115 109 112 113 113 113 113 114 37 4 5 5 5 5 5 5 5 5 5 5 5 5 5 5 5 5 5 5 5 5 5 5 5 5 5 5 5 6 37 37 37 37 37 37 37 37 37 37 37 112 113 113 113 113 113 114 115 110 111 123 37 37 37 37 37 37 37 37 29 29 29 37 37 37 29 29 29 37 37 37 37 37 16 17 37 37 16 17 72 87 88 71 37 37 37 37 37 37 37 37 37 37 37 37 108 109 110 65 114 101 37 16 17 37 37 17 17 37 70 88 88 88 88 71 37 42 28 28 28 28 28 44 45 28 28 61 28 28 28 28 28 28 44 45 61 28
4 5 5 5 5 5 5 5 5 5 5 5 5 5 5 5 5 5 5 5 5 5 5 5 5 5 5 5 5 5 5 5 5 5 5 5 5 5 6 20 21 21 21 21 21 21 21 21 21 21 21 21 21 21 21 21 21 21 21 21 21 21 21 21 21 21 21 22 37 37 37 37 4 5 5 5 5 5 5 5 5 5 5 5 5 5 5 5 5 5 5 5 5 6 37 37 4 5 5 5 6 37 37 37 4 5 5 5 5 5 5 5 5 5 5 5 5 5 5 5 5 5 5 5 5 5 5 5 5 5 5 5 5 5 5 5 5 5 5 6 37 4 5 5 5 5 5 5 5 5 5 5 5 5 5 5 5 5 5 5 5 5 5 5 5 5 5 5 5 5 5 5 5 5 5 6
</MapIndexes>

<MarioAnimations>
# Standing > Running > Jumping > Dropping
# Every animation has a param is: delay frame after this character: >

# Stading
0,0,16,16
> 2

# Running
0,0,16,16
16,0,16,16
> 2

#Jumping
32,0,16,16
> 2

#Dropping
32,0,16,16
> 2
</MarioAnimations>

<MarioInfo>
#(x,y,limitX,limitY,state)
0,0,2816,470,DROPPING
</MarioInfo>

<Grounds>
#(x,y,width,height,id,cellX,cellY)
0,416,624,48,0
624,400,464,64,1
1152,416,352,48,2
1536,416,80,48,3
1664,416,572,48,4
# decreased 4 for upper line(576 -> 572)
2260,416,560,48,5
# increased 4 for upper line(2256 -> 2260)

# Ground stairs
1504,336,32,16,6

1568,400,16,16,7
1584,384,16,32,8
1600,368,16,48,9

1664,400,48,16,10
1664,384,32,16,11
1664,368,16,16,12
</Grounds>

# Golden Brick: Static Animation(for UI) + Ground(for collision)
<GoldenBrickFrames>
# (x, y, width, height, id)
1952,400,16,16,13
1968,400,16,16,14
1984,400,16,16,15
2000,400,16,16,16
2016,400,16,16,17
2032,400,16,16,18
2048,400,16,16,19

1968,384,16,16,20
1984,384,16,16,21
2000,384,16,16,22
2016,384,16,16,23
2032,384,16,16,24

1984,368,16,16,25
2000,368,16,16,26
2016,368,16,16,27
2032,368,16,16,28

2096,400,16,16,29
2112,400,16,16,30
2096,384,16,16,31
</GoldenBrickFrames>

<GoldenBrickAnimation>
# (x, y, width, height)
204,119,16,16
221,119,16,16
238,119,16,16
255,119,16,16
> 2
</GoldenBrickAnimation>

<GiftBrickFrames>
176,352,16,16
</GiftBrickFrames>

<ScoreBoard>
0,150
</ScoreBoard>

<GridInfo>
# (totalRow, totalCol, cellHeight, cellWidth)
5,22,94,128
</GridInfo>

<GridMatrixId>
# every pair
# > id
# cellX1,cellY1_cellX2,cellY2
> 0
0,4_1,4_2,4_3,4_4,4

> 1
4,4_5,4_6,4_7,4_8,4

> 2
8,4_9,4_10,4_11,4

> 3
11,4_12,4

> 4
12,4_13,4_14,4_15,4_16,4_17,4

> 5
17,4_18,4_19,4_20,4_21,4

> 6
11,3

> 7
12,4

> 8
12,3_12,4

> 9
12,3_12,4

> 10
12,4_13,4

> 11
12,3_13,3_12,4_13,4

> 12
12,3_13,3_12,4_13,4

> 13
15,4

> 14
15,4

> 15
15,4

> 16
15,4

> 17
15,4

> 18
15,4

> 19
15,4

> 20
15,3

> 21
15,3

> 22
15,3

> 23
15,3

> 24
15,3

> 25
15,3

> 26
15,3

> 27
15,3

> 28
15,3

> 29
16,4

> 30
16,4

> 31
16,3
</GridMatrixId>

<AnimationBundle>
# > id, startIndexFrame, animationDelay
# GiftBrick secret animation
170,0,16,16
187,0,16,16
204,0,16,16
221,0,16,16
> 0 0 2

# GiftBrick empty box
238,0,16,16
> 1 0 10

# GiftBrick coin animation
255,0,16,16
255,17,16,16
255,34,16,16
255,51,16,16
> 2 0 2

# GiftBrick 100 coins
102,34,16,16
> 3 0 10
</AnimationBundle>