<ViewController>
# 0. beginSuperMushroomId, endSuperMushroomId
0,100

# 1. beginGoombaId, endGoombaId
101,200

# 2. beginKoopaId, endKoopaId
201,300

# 3. beginGiftBrickId, endGiftBrickId
301,400

# 4. beginGroundId, endGroundId
401,500

# 5. beginBlockId, endBlockId
501,600

# 6. beginGoldenBrickId, endGoldenBrickId
601,700

# 7. beginFireFlowerId, endFireFlowerId, beginFlowerId, endFlowerId
701,750,751,800

# 8. beginGreenPipeId, endGreenPipeId, greenPipeIdToUnderground,
# leftAnchorGreenPipeToUnderground, rightAnchorGreenPipeToUnderground,
# leftAnchorMarioPoppingUpFromPipe, bottomAnchorMarioPoppingUpFromPipe
801,900,805,2263,2281,2324,384

# 9. beginSuperLeafId, endSuperLeafId
901,1000

# 10. beginFireBallId, endFireBallId, beginFireFlowerBallId, endFireFlowerBallId
1001,1050,1051,1100

# 11. beginCoinId, endCoinId
1101,1200

# 12. beginPButtonId, endPButtonId
1201,1300

</ViewController>

<MapInfo>
#(tileSize, spaceBetweenTiles, tilesPerRowInTileSet, tilesPerColumnInTileSet, width, height)
16,1,16,8,2816,432
</MapInfo>

<MapIndexes>
37 37 37 37 37 37 37 37 37 37 37 37 37 37 37 37 37 37 37 37 37 37 37 37 37 37 37 37 37 37 37 37 37 37 37 37 37 37 37 37 37 37 37 37 37 37 37 37 37 37 37 37 37 37 37 37 37 37 37 37 37 37 37 37 37 37 37 37 37 37 37 37 37 37 37 37 37 37 37 37 37 37 37 37 37 37 37 37 37 37 37 37 37 37 37 37 37 37 37 37 37 37 37 37 37 37 37 37 37 37 37 37 37 37 37 37 37 37 37 37 37 37 37 37 37 37 37 37 37 37 37 37 37 37 37 37 37 37 37 37 37 37 37 37 37 37 37 37 37 34 37 37 37 34 37 42 28 28 28 28 28 28 28 28 28 28 28 28 28 28 28 28 28 28 28 28
37 37 37 37 37 37 37 37 37 37 37 37 37 37 37 37 37 37 37 37 37 37 37 37 37 37 37 37 37 37 37 37 37 37 37 37 37 37 37 37 37 37 35 37 37 37 37 34 37 37 37 37 37 37 37 37 37 37 37 37 37 37 37 37 37 37 37 37 37 37 37 37 37 37 37 37 37 37 37 37 37 37 37 37 37 37 37 37 37 37 37 37 37 37 37 37 37 37 37 37 37 37 37 37 37 37 37 37 37 37 37 37 37 37 37 37 37 37 37 37 36 37 35 37 37 37 37 37 37 37 37 37 37 37 37 37 37 37 37 37 37 37 37 37 37 37 37 37 37 37 37 37 37 37 37 42 28 28 28 28 28 28 28 28 28 28 28 28 28 28 28 28 28 28 28 28
37 37 37 37 37 37 37 34 37 37 37 37 37 37 37 37 36 37 37 37 37 34 37 37 37 37 37 37 37 37 37 37 37 37 37 37 37 37 37 37 37 37 37 37 37 37 37 37 37 37 37 37 37 37 37 37 37 37 37 37 37 37 37 37 37 37 37 37 37 37 37 37 37 37 37 37 37 37 37 37 37 37 37 37 37 34 37 37 37 37 37 37 37 37 37 37 37 37 37 37 37 34 37 37 37 37 37 37 37 37 37 37 37 37 37 37 37 37 37 37 37 37 37 37 37 37 37 37 37 37 37 37 37 37 37 37 37 37 37 37 37 37 37 37 37 37 37 37 37 37 37 37 37 37 37 42 28 28 28 28 28 28 28 28 28 28 28 28 28 28 28 28 28 28 28 28
37 37 37 37 37 37 37 37 37 37 37 37 37 37 37 37 37 37 37 37 37 37 37 37 37 37 37 37 37 37 37 37 37 37 37 37 37 34 35 37 37 37 37 37 37 37 37 34 37 37 35 37 37 37 37 37 37 37 37 37 37 37 37 37 37 37 37 37 37 37 37 37 37 37 37 37 37 37 37 34 37 37 37 37 37 37 37 37 37 37 37 37 37 37 37 37 37 37 37 37 37 37 37 37 37 37 37 37 37 37 37 37 37 37 37 37 37 37 37 37 37 37 37 37 37 37 37 37 37 37 37 37 37 37 37 37 37 37 37 37 37 37 37 37 37 37 37 37 37 37 37 37 37 37 37 42 28 28 28 28 28 28 28 28 28 28 28 28 28 28 28 28 28 28 28 28
37 37 37 37 37 37 37 37 37 37 37 37 37 37 35 37 36 37 37 37 37 37 37 34 37 37 37 37 37 37 37 37 37 37 37 37 37 37 37 37 37 37 37 37 37 37 37 37 37 37 37 37 36 37 37 37 37 37 37 37 37 37 37 37 37 37 37 37 37 37 37 37 37 37 37 37 37 37 37 37 37 37 37 37 37 37 37 37 37 37 37 37 37 37 35 37 37 37 37 37 37 37 37 37 37 34 37 37 36 37 37 37 37 37 37 37 37 37 37 37 37 37 37 37 37 37 37 37 37 37 37 37 37 37 37 37 37 37 37 37 37 37 37 37 37 37 37 37 37 37 37 37 37 37 37 42 28 28 28 28 28 28 28 28 28 28 28 28 28 28 28 28 28 28 28 28
37 37 37 37 37 37 37 37 37 37 37 37 37 37 37 37 37 37 35 34 37 37 37 37 37 37 37 37 37 37 37 37 37 37 37 37 37 37 37 37 37 37 37 37 37 37 37 37 37 37 37 37 37 37 37 37 37 37 37 37 37 37 37 37 37 37 37 37 37 37 37 37 37 37 37 37 37 37 37 37 37 37 37 37 37 37 37 37 37 37 37 37 37 34 37 37 37 37 37 37 37 37 37 37 37 37 37 37 37 37 37 37 37 37 37 37 36 37 37 37 37 37 37 37 37 37 37 37 37 37 37 37 37 37 37 37 37 37 37 34 37 37 37 37 37 37 37 37 37 37 37 37 37 37 37 42 28 28 28 28 28 28 28 28 28 28 28 28 28 28 28 28 28 28 28 28
37 37 37 37 37 37 37 37 37 37 37 37 37 37 37 37 37 37 37 37 37 37 37 37 37 37 37 37 37 37 37 37 37 37 37 37 37 37 37 37 37 37 37 37 37 37 37 37 37 37 37 37 37 37 37 37 37 37 37 37 36 37 37 37 37 37 37 37 37 37 37 37 37 37 37 37 37 37 37 37 37 37 37 37 37 37 37 37 37 37 37 34 37 37 35 37 37 37 37 37 37 37 37 37 37 37 37 37 37 37 37 37 37 37 37 37 37 37 37 37 37 37 37 37 37 37 37 37 37 37 37 37 37 37 37 37 37 37 37 37 37 37 37 37 37 37 37 37 37 37 37 37 37 37 37 42 28 28 28 28 28 28 28 28 28 28 28 28 28 28 28 28 28 28 28 28
37 37 37 37 37 37 37 37 37 37 37 37 37 37 37 37 37 37 37 37 37 37 37 37 37 37 37 37 37 37 37 37 37 37 37 37 37 37 37 37 37 37 37 37 37 37 37 37 37 37 37 37 37 37 37 37 37 37 37 37 37 37 37 37 37 37 37 37 37 37 37 37 37 37 37 37 37 37 37 37 37 37 37 37 37 37 37 37 37 37 37 37 37 37 37 37 37 37 37 37 37 37 37 37 37 37 37 37 37 37 37 37 37 37 37 37 37 37 37 37 37 37 37 37 37 37 37 37 37 37 37 37 36 37 37 37 37 37 37 37 37 0 1 37 37 37 37 37 37 37 37 37 37 37 37 42 28 28 28 28 28 28 28 28 28 28 28 28 28 28 28 28 28 28 28 28
37 37 37 37 37 37 37 37 37 37 37 37 37 37 37 37 37 37 37 37 37 37 37 37 37 37 37 37 37 37 37 37 37 37 37 37 37 37 37 37 37 37 37 37 37 37 37 37 37 37 37 37 37 37 37 37 37 37 37 37 37 37 37 37 37 37 37 37 37 34 37 37 37 37 37 37 37 37 37 37 37 37 37 37 37 37 37 37 37 37 37 37 37 37 37 37 37 37 37 37 37 37 37 37 37 37 37 37 37 37 37 37 37 37 37 37 37 37 37 37 37 37 37 37 37 37 37 37 37 37 37 37 37 37 37 37 37 37 37 37 37 16 17 37 37 37 37 37 37 37 37 34 37 37 37 42 28 28 28 28 28 28 28 28 28 28 28 28 28 28 28 28 28 28 28 28
37 37 37 37 37 37 37 37 37 37 37 37 37 37 37 37 37 37 37 37 37 37 37 37 37 37 37 37 37 37 37 37 37 37 37 37 37 37 37 37 37 37 37 37 37 37 37 37 37 37 37 37 37 37 37 37 37 37 37 37 37 37 37 37 37 37 37 37 37 37 37 37 37 37 35 37 36 37 37 37 37 37 76 77 77 78 85 34 37 37 37 37 37 37 37 37 37 37 37 37 37 37 37 37 37 37 37 37 37 37 37 37 37 37 37 37 37 37 37 37 36 37 37 37 37 37 37 37 37 37 37 37 37 37 37 37 37 37 37 37 37 16 17 37 37 37 37 37 37 37 37 37 37 37 37 42 28 28 28 28 28 28 28 28 28 28 28 28 28 28 28 28 28 28 28 28
37 37 37 37 37 37 37 37 37 37 37 37 37 37 37 37 37 37 37 37 37 37 37 37 37 37 37 37 37 37 37 37 37 37 37 37 37 37 37 37 37 37 37 37 37 37 37 37 37 37 37 37 37 37 37 37 37 37 37 37 37 37 37 37 37 37 37 37 37 37 37 37 37 37 37 37 37 37 37 37 37 37 108 109 109 110 101 37 37 37 37 37 37 37 37 37 37 37 37 37 37 37 37 37 37 37 37 37 37 37 37 37 37 37 37 37 37 37 37 37 37 37 37 37 37 37 37 37 37 37 37 37 37 37 37 37 37 37 37 37 37 16 17 37 37 37 37 37 37 37 37 37 37 37 37 42 28 28 28 28 28 28 28 28 28 28 28 28 28 28 28 28 28 28 28 28
37 37 37 37 37 37 37 37 37 37 37 37 37 37 37 37 37 37 37 37 37 37 37 37 37 37 37 37 37 37 37 37 37 37 37 37 37 37 37 37 37 37 37 37 37 37 37 37 37 37 37 37 37 37 37 37 37 37 37 37 37 37 37 37 37 37 37 37 37 37 37 37 37 37 37 37 37 37 37 37 37 37 7 8 8 8 9 37 37 37 37 37 37 50 50 50 50 50 50 50 50 50 50 50 50 50 37 37 37 37 37 37 37 37 37 37 37 37 37 37 37 37 37 37 37 37 37 37 37 37 37 37 37 37 37 37 37 37 37 37 37 16 17 37 37 37 37 37 37 37 37 37 37 37 37 42 28 28 28 28 28 28 28 28 28 28 28 28 28 28 28 28 28 28 28 28
37 37 37 37 37 37 37 37 37 37 37 37 37 37 37 37 37 37 37 37 37 37 37 37 37 37 37 37 37 37 37 37 37 37 37 37 37 37 37 37 37 37 37 37 37 37 37 37 37 37 37 37 37 37 37 37 37 37 37 37 37 37 37 37 37 37 37 37 37 37 37 37 37 37 37 37 37 37 37 37 37 37 37 37 37 37 37 37 50 50 50 50 37 37 37 37 37 37 37 37 37 37 37 37 37 37 37 37 37 37 37 37 37 37 37 37 37 37 37 37 37 37 37 37 37 37 37 37 37 37 37 37 37 37 37 37 37 37 37 37 37 16 17 37 37 37 37 37 37 37 37 37 37 37 37 42 28 28 28 28 28 28 28 28 28 28 28 28 28 28 28 28 28 28 28 28
37 37 37 37 37 37 37 37 37 37 37 37 37 37 37 37 37 37 37 37 37 37 37 37 37 37 37 37 37 37 37 37 37 37 37 37 37 37 37 37 37 37 37 37 37 37 37 37 37 37 37 37 37 37 37 37 37 37 37 37 37 37 37 37 37 37 37 37 37 37 37 37 37 37 37 37 37 37 37 37 37 37 37 37 37 37 37 37 37 37 37 37 37 37 37 37 37 37 37 37 37 37 37 37 37 37 37 37 37 37 37 37 37 37 37 37 37 37 37 37 37 37 37 37 37 37 37 37 37 37 37 37 37 37 37 37 37 37 37 37 37 16 17 37 37 37 37 37 37 37 37 37 37 37 37 42 28 28 28 28 28 28 28 28 28 28 28 28 28 28 28 28 28 28 28 28
37 37 37 37 37 37 37 37 37 37 37 37 37 37 37 37 37 37 37 37 37 37 37 37 37 37 37 37 37 37 37 37 37 37 37 37 37 37 37 37 37 37 37 37 37 37 37 37 37 37 37 37 37 37 37 37 37 37 37 37 37 37 37 37 37 37 37 37 37 37 37 37 37 37 37 37 37 37 37 37 37 37 37 37 37 37 37 37 37 37 37 37 37 37 37 37 37 37 37 37 37 37 37 37 37 37 37 37 37 37 37 37 37 37 37 37 37 37 37 37 37 37 37 37 37 37 37 37 37 37 37 37 37 37 37 37 37 37 37 37 37 16 17 37 37 37 37 37 37 37 37 37 37 37 37 42 28 28 28 28 28 28 28 28 28 28 28 28 28 28 28 28 28 28 28 28
37 37 37 37 37 37 37 37 37 37 37 37 37 37 37 37 37 37 37 37 37 37 37 37 37 37 37 37 37 37 37 37 37 37 37 37 37 37 37 37 37 37 37 37 37 37 37 37 37 37 37 37 37 37 37 37 37 37 37 37 37 37 37 37 37 37 37 37 37 37 37 37 37 37 37 37 37 37 37 37 37 37 37 37 37 37 37 37 37 37 37 37 37 37 37 37 37 37 37 37 37 37 37 37 37 37 37 37 37 37 37 37 37 37 37 37 37 37 37 37 37 37 37 37 37 37 37 37 37 37 37 37 37 37 37 37 37 37 37 37 37 16 17 37 37 37 37 37 37 37 37 37 37 37 37 42 28 28 28 28 28 28 28 28 28 28 28 28 28 28 28 28 28 28 28 28
37 37 37 37 37 37 37 37 37 37 37 37 37 37 37 37 37 37 37 37 37 37 37 37 37 37 37 37 37 37 37 37 37 37 37 37 37 37 37 37 37 37 37 37 37 37 37 37 37 37 37 37 37 37 37 37 37 37 37 37 37 37 37 37 37 37 37 37 37 37 37 37 37 37 37 37 37 37 37 37 37 37 37 37 37 37 37 37 37 37 37 37 37 37 37 37 37 37 37 37 37 37 37 37 37 37 37 37 37 37 37 37 37 37 37 37 37 37 37 37 37 37 37 37 37 37 37 37 37 37 37 37 37 37 37 37 37 37 37 37 37 16 17 37 37 37 37 37 37 37 37 37 37 37 37 42 28 28 28 28 28 28 28 28 28 28 28 28 28 28 28 28 28 28 28 28
37 37 37 37 37 37 37 37 51 52 53 37 37 37 37 37 37 37 37 37 37 37 37 37 37 37 37 37 37 37 37 37 37 37 37 37 37 37 37 37 51 52 53 37 37 37 37 37 37 37 37 37 37 37 37 37 37 37 37 37 37 37 37 37 37 37 37 37 37 37 37 37 37 37 37 37 37 37 37 37 37 37 37 37 37 37 37 37 37 37 37 37 37 37 37 37 37 37 37 37 37 37 37 51 52 52 52 53 37 37 37 37 37 37 37 37 37 37 37 37 37 37 37 37 37 37 37 37 37 37 37 37 37 37 37 37 80 81 82 85 37 16 17 37 37 37 37 37 37 37 37 37 37 37 37 42 28 28 28 28 28 28 28 28 28 28 28 28 28 28 28 28 28 28 28 28
37 37 37 37 37 37 37 37 67 68 69 37 37 37 37 37 37 37 37 37 37 37 37 37 37 37 37 37 37 37 37 37 37 37 37 37 37 37 37 37 67 68 69 37 37 37 37 37 37 37 37 37 37 37 37 37 37 37 37 37 37 37 37 37 37 37 37 37 37 37 37 37 37 37 37 37 37 37 37 37 37 37 37 37 37 37 37 37 37 37 37 37 37 37 37 37 37 37 37 37 37 37 37 67 68 68 68 69 37 37 37 37 37 37 37 37 37 37 37 37 37 37 37 37 37 37 37 37 37 37 37 37 37 37 37 37 96 56 98 101 37 16 17 37 37 51 52 53 37 37 72 73 37 37 37 42 28 28 28 28 28 28 28 28 28 28 28 28 28 28 28 28 28 28 28 28
37 37 37 37 37 37 37 37 37 37 37 37 37 37 37 37 37 37 37 37 37 37 37 37 37 37 37 37 37 37 37 37 102 103 103 104 85 37 37 37 37 37 37 37 51 52 52 52 53 37 37 37 37 37 37 37 37 37 37 37 37 37 37 37 37 37 37 37 37 37 37 37 37 37 37 37 37 37 37 37 37 37 37 37 37 37 37 37 37 37 37 37 37 37 37 37 37 37 37 37 37 37 37 37 37 37 37 37 37 37 37 37 37 37 37 37 37 37 37 37 37 37 37 37 37 37 37 37 37 37 37 37 37 37 37 37 96 56 98 101 37 29 29 37 37 67 68 69 37 37 70 86 73 37 37 42 28 28 28 28 28 28 28 28 28 28 28 28 28 28 28 28 28 28 28 28
37 37 37 37 37 37 37 37 37 37 37 37 37 37 37 37 37 37 37 37 37 37 37 37 37 37 37 37 37 37 37 37 118 119 119 120 101 37 37 37 37 37 37 37 67 68 68 68 69 37 37 37 37 37 37 37 37 37 37 37 37 37 37 37 37 37 37 37 37 37 37 37 37 37 37 37 37 37 37 37 37 37 37 89 90 90 90 90 90 91 85 37 37 37 37 37 37 37 37 37 37 37 37 37 37 37 37 37 37 37 37 37 37 37 37 37 37 37 37 37 37 37 37 37 37 37 37 37 37 37 37 37 37 37 37 37 96 56 98 101 37 37 37 37 37 37 37 37 37 37 70 88 71 37 37 42 28 28 28 28 28 28 44 45 28 28 28 28 28 28 28 28 28 28 28 28
37 37 37 37 37 37 37 37 37 37 37 37 37 37 37 37 37 89 90 91 85 37 37 37 37 37 37 37 37 76 77 77 78 84 119 120 101 37 37 37 37 37 37 37 37 37 37 37 37 37 37 37 37 37 37 72 73 37 37 37 37 37 37 37 37 37 37 37 37 37 37 37 37 37 37 37 37 37 37 37 37 37 37 105 106 106 106 106 106 107 101 37 37 37 29 29 37 37 37 37 37 37 37 37 37 37 37 37 37 37 37 37 37 37 37 37 37 37 37 37 37 37 37 37 37 37 37 37 37 37 37 37 37 37 37 37 96 56 98 101 37 37 37 37 37 37 37 37 37 72 87 88 71 37 37 42 28 28 28 28 28 28 60 61 28 28 28 28 28 28 28 28 28 28 28 28
37 37 72 73 37 37 37 37 37 37 37 37 37 37 37 37 37 105 106 107 101 37 37 37 37 37 37 37 37 92 93 93 94 100 119 120 101 37 37 37 37 37 37 37 37 37 37 37 37 37 37 37 72 73 72 87 71 72 73 37 72 73 37 37 37 37 37 37 37 37 37 37 37 37 37 37 37 37 37 37 37 76 77 77 77 77 77 78 79 107 101 37 37 37 37 37 37 37 37 37 37 37 37 37 37 37 37 37 37 37 37 37 37 37 37 37 37 37 37 37 37 37 37 37 37 37 37 37 37 37 37 37 37 37 37 37 96 56 98 101 37 37 37 37 37 37 37 37 72 87 88 88 71 37 37 42 28 28 28 28 28 28 60 44 45 28 28 28 28 28 28 28 28 28 28 28
37 72 87 71 72 73 72 73 37 37 37 37 37 37 37 76 77 78 79 107 101 37 37 37 37 80 81 81 81 82 83 93 94 100 119 120 101 37 37 37 37 37 37 37 37 37 37 37 37 37 37 37 70 86 87 86 87 88 71 37 70 86 73 37 37 37 37 37 37 37 37 37 37 37 37 37 37 37 37 37 37 92 93 93 93 93 93 94 95 107 101 37 37 37 37 37 37 37 37 37 29 37 37 37 29 37 37 37 37 37 37 37 37 37 37 37 37 37 37 72 73 37 37 37 37 37 37 37 37 37 37 37 37 37 76 77 78 33 98 101 37 29 29 37 37 37 37 37 70 88 88 88 71 37 37 42 28 28 28 28 28 28 60 28 61 28 28 28 28 28 28 28 28 44 45 28
37 70 86 87 88 71 70 86 73 37 37 37 37 37 37 92 93 94 95 107 101 37 37 37 37 96 56 56 56 98 99 93 80 81 81 81 81 82 85 37 37 37 66 66 66 66 66 66 37 37 37 72 87 88 88 88 88 88 71 72 87 88 71 37 37 37 37 37 37 37 37 37 37 37 37 37 37 37 37 80 81 81 81 81 81 82 83 94 95 107 101 37 37 37 37 37 37 37 37 29 29 37 37 37 29 29 37 37 37 37 37 37 37 37 37 37 37 37 37 70 86 73 37 37 37 37 37 37 37 37 37 37 37 37 92 93 94 49 98 101 37 16 17 37 37 37 37 37 70 88 88 88 86 73 37 42 28 28 28 28 28 28 60 28 44 45 28 28 28 28 28 28 28 60 61 28
37 70 88 88 88 86 87 88 71 37 66 66 66 37 37 108 109 110 111 123 101 37 37 37 37 112 113 113 113 114 115 109 112 113 113 113 113 114 101 4 5 5 5 5 5 5 5 5 5 5 5 5 5 5 5 5 5 5 5 5 5 5 5 5 5 5 5 6 37 37 37 37 37 37 37 37 37 37 37 112 113 113 113 113 113 114 115 110 111 123 101 37 37 37 37 37 37 37 29 29 29 37 37 37 29 29 29 37 37 37 37 37 37 37 37 37 37 37 72 87 88 71 37 37 37 37 37 37 37 37 37 37 37 37 108 109 110 65 114 101 37 16 17 37 37 37 37 37 70 88 88 88 88 71 37 42 28 28 28 28 28 44 45 28 28 61 28 28 28 28 28 28 44 45 61 28
4 5 5 5 5 5 5 5 5 5 5 5 5 5 5 5 5 5 5 5 5 5 5 5 5 5 5 5 5 5 5 5 5 5 5 5 5 5 6 20 21 21 21 21 21 21 21 21 21 21 21 21 21 21 21 21 21 21 21 21 21 21 21 21 21 21 21 22 37 37 37 37 4 5 5 5 5 5 5 5 5 5 5 5 5 5 5 5 5 5 5 5 5 6 37 37 4 5 5 5 6 37 37 37 4 5 5 5 5 5 5 5 5 5 5 5 5 5 5 5 5 5 5 5 5 5 5 5 5 5 5 5 5 5 5 5 5 5 5 6 37 4 5 5 5 5 5 5 5 5 5 5 5 5 5 5 5 5 5 5 5 5 5 5 5 5 5 5 5 5 5 5 5 5 5 6
</MapIndexes>

<MarioInfo>
# (x, y, limitX, limitY)
36,384,2816,470
</MarioInfo>

<GiftBrickFrames>
# (x, y, width, height, id, isFakeGoldenBrick, giftCode,
# giftCode:
# 0: SuperMushroom and SuperLeaf
# superMushroomWidth, superMushroomHeight, superMushroomVx, superMushroomVy, superMushroomId,
# superLeafWidth, superLeafHeight, superLeafVx, superLeafVy, superLeafId,
# superMushroomDefaultPoints, superLeafDefaultPoints)

# 1: 100 points

# 2: SuperMushroom Green
# width, height, vx, vy, id, isGreenMode

# 3: Multi Coin
176,352,16,16,301,0,1
192,352,16,16,302,0,1

224,304,16,16,303,0,1
240,304,16,16,304,0,0,16,16,1,1,0,16,16,1,1,901,1000,1000

416,314,16,16,305,0,1

656,384,16,16,306,0,0,16,16,1,1,1,16,16,1,1,902,1000,1000
704,346,16,16,307,0,1

1472,362,16,16,308,0,0,16,16,1,1,2,16,16,1,1,903,1000,1000

1432,128,16,16,309,1,2,16,16,1,1,3,1
</GiftBrickFrames>

<GoombaFrames>
# (x, y, width, height, vx, vy, defaultPoint, id, isFlyingMode)
240,400,16,16,-1,1,100,101,0
560,400,16,16,-1,1,100,102,0
800,384,16,16,-1,1,100,103,0
912,384,16,16,-1,1,100,104,0
1032,376,20,24,-1,1,100,105,1
</GoombaFrames>

<KoopaFrames>
# (x, y, vx, vy, defaultPoint, id, mode, leftAnchor, rightAnchor)
# mode
# 1: green
# 2: flying
# In green mode or flying mode, there is No any anchors
# red
512,357,1,2,100,201,0,512,608

# green
1440,389,-1,2,100,202,1

# red
2088,357,1,2,100,203,0,2088,2116

# flying
#1408,292,-1,2,100,204,2
1360,292,-1,2,100,205,2
1312,324,-1,2,100,206,2
</KoopaFrames>

<Grounds>
#(x, y, width, height, id)
# every ground plus 32 into height
0,416,624,48,401
624,400,464,64,402
1152,416,352,48,403
1536,416,80,48,404
1664,416,570,48,405
# decreased 6 for upper line(576 -> 570)
2262,416,560,48,406
# increased 6 for upper line(2256 -> 2262)

# Ground stairs
1504,336,32,16,407

1568,400,16,16,408
1584,384,16,32,409
1600,368,16,48,410

1664,400,48,16,411
1664,384,32,16,412
1664,368,16,16,413

#Ground GreenPipes
2256,368,32,48,414
2256,160,32,160,415
</Grounds>

<BlockFrames>
240,368,48,48,501
272,336,48,80,502

# use 392 intead of 400
392,368,80,48,503
464,336,64,80,504
512,304,64,112,505
512,384,96,32,506
1262,384,112,32,507
1296,352,112,64,508
1328,320,112,96,509
1312,144,64,32,510
2144,368,48,48,511
2176,272,48,144,512

# Block Clouds
1408,192,64,16,513
1488,176,208,16,514
</BlockFrames>

# Golden Brick: Static Animation(for UI) + Ground(for collision)
<GoldenBrickFrames>
# (x, y, width, height, hasPButton, id)
# 0: Not thing
# 1: P Button : pButtonX, pButtonY, pButtonId

1952,400,16,16,0,601
1968,400,16,16,0,602
1984,400,16,16,0,603
2000,400,16,16,0,604
2016,400,16,16,0,605
2032,400,16,16,0,606
2048,400,16,16,0,607

1968,384,16,16,0,608
1984,384,16,16,0,609
2000,384,16,16,0,610
2016,384,16,16,0,611
2032,384,16,16,0,612

1984,368,16,16,0,613
2000,368,16,16,0,614
2016,368,16,16,0,615
2032,368,16,16,1,616,2032,352,1201

2096,400,16,16,0,617
2112,400,16,16,0,618
2096,384,16,16,0,619
</GoldenBrickFrames>

<FireFlowerFrames>
# (x, y, vy, topAnchor, bottomAnchor, leftAnchor, rightAnchor, halfSizeMode, greenMode, defaultPoint, id, ballX, ballY, ballVx, ballVy, ballId)
360,368,0.5,336,368,342,394,0,0,100,701,368,376,1,0.5,1051
1864,368,0.5,344,368,1846,1898,1,1,100,702,1872,384,1,0.5,1052
</FireFlowerFrames>

<FlowerFrames>
# (x, y, vy, topAnchor, bottomAnchor, leftAnchor, rightAnchor, halfSizeMode, greenMode, defaultPoint, id)
1800,384,0.5,360,384,1762,1834,1,1,100,751
</FlowerFrames>

<GreenPipeFrames>
# (x, y, width, height, floorQuantity, id, isBlackMode, isDownMode)
# floorQuantity: 3 or 2
352,368,32,48,3,801,0,0
1792,384,32,32,2,802,0,0
1856,368,32,48,3,803,0,0

# This is component help mario move to underground map
2256,112,32,48,3,805,0,0

2320,384,32,32,2,804,0,0
</GreenPipeFrames>

<CoinFrames>
1088,336,1101
1120,304,1102
1152,272,1103
1184,240,1104
1216,208,1105

1328,96,1106
1344,96,1107
1360,96,1108

1488,104,1109
1504,104,1110

1536,120,1111
1552,120,1112
1568,120,1113
1584,120,1114

1616,104,1115
1632,104,1116
1648,104,1117
1664,104,1118

1696,136,1119
1728,104,1120
1760,120,1121
1808,88,1122
1840,120,1123
</CoinFrames>
