<Setting>
#(dt,fps,width,height,isFullScreen,backBufferColor,debugMode)
1.0,60,224,144,0,black,0
</Setting>

<Camera>
#(x,y,vX,vY,width,height,limitX,limitY)
0,0,0,0,224,144,224,144
</Camera>

<MapInfo>
#(tileSize, spaceBetweenTiles, tilesPerRowInTileSet, tilesPerColumnInTileSet, width, height)
16,1,10,5,224,144
</MapInfo>

<MapIndexes>
10 10 10 22 40 8 40 23 40 24 40 8 10 10
10 10 10 41 10 10 10 41 10 10 10 41 10 10
40 20 40 29 10 10 10 9 40 25 40 14 10 10
10 10 10 15 10 10 10 41 10 10 10 10 10 10
10 10 10 9 40 4 40 21 10 10 33 31 32 10
10 0 0 41 0 10 10 10 33 31 35 2 30 10
0 0 37 9 37 14 40 8 34 8 40 3 30 10
0 37 37 41 37 37 0 41 30 0 0 0 30 10
0 37 37 26 40 8 40 27 36 31 31 31 35 10
</MapIndexes>
<GrassesId>
10,11,12,13
</GrassesId>